A110001000
0100101000
0000100000
0111111110
0100000000
1101011111
0000000000
1111111101
1000100000
G010001000